<html>@@@@@@@@@@@@@@@@@@@@@@@@@@@@@@@@@@@@@@@@@@@@@@@@@@<br/>
@@@@@@@@@@@@@@@@@@%%%%%%%%%%%%%%@@@@@@@@@@@@@@@@@@<br/>
@@@@@@@@@@@@@@@@@@::::::::::::::@@@@@@@@@@@@@@@@@@<br/>
@@@@@@@@@@@@@@@@@@::::::::::::::@@@@@@@@@@@@@@@@@@<br/>
@@@@@@@@@@@@@@@@@@::::::::::::::@@@@@@@@@@@@@@@@@@<br/>
@@@@@@@@@@@@@@@@@@:::ENTRANCE:::@@@@@@@@@@@@@@@@@@<br/>
@@@@@@@@@@@@@@@@@@::::::::::::::@@@@@@@@@@@@@@@@@@<br/>
@@@@@@@@@@@@@@@@@@::::::::::::::@@@@@@@@@@@@@@@@@@<br/>
@@@@@@@@@@@@@@@@@@::::::::::::::@@@@@@@@@@@@@@@@@@<br/>
@@@@@@@@@@@@@@@@@@##############@@@@@@@@@@@@@@@@@@<br/>
@@%%%%%%%%%%%%%%@@%%%%%%%%%%%%%%@@%%%%%%%%%%%%%%@@<br/>
@%:::::::::::::-@@::::::::::::::@@-:::::::::::::%@<br/>
@%:::::::::::::-@@::::::::::::::@@-:::::::::::::%@<br/>
@%:::::::::::::-@@::::::::::::::@@-:::::::::::::%@<br/>
@%:::KITCHEN:::-@@:::NORTH::::::@@-:::LIVING::::%@<br/>
@%:::::::::::::-@@:::HALLWAY::::@@-:::ROOM::::::%@<br/>
@%:::::::::::::-@@::::::::::::::@@-:::::::::::::%@<br/>
@%:::::::::::::-@@::::::::::::::@@-:::::::::::::%@<br/>
@@##############@@##############@@##############@@<br/>
@@##############@@##############@@##############@@<br/>
@%:::::::::::::-@@::::::::::::::@@-:::::::::::::%@<br/>
@%:::::::::::::-@@::::::::::::::@@-:::::::::::::%@<br/>
@%:::::::::::::-@@::::::::::::::@@-:::::::::::::%@<br/>
@%:::DINING::::-@@:::CENTRAL::::@@-:::ARMORY::::%@<br/>
@%:::::::::::::-@@:::HALLWAY::::@@-:::::::::::::%@<br/>
@%:::::::::::::-@@::::::::::::::@@-:::::::::::::%@<br/>
@%:::::::::::::-@@::::::::::::::@@-:::::::::::::%@<br/>
@@%%%%%%%%%%%%%%@@%%%%%%%%%%%%%%@@%%%%%%%%%%%%%%@@<br/>
@@##############@@##############@@##############@@<br/>
@%:::::::::::::-@@::::::::::::::@@-:::::::::::::%@<br/>
@%:::::::::::::-@@::::::::::::::@@-:::::::::::::%@<br/>
@%:::::::::::::-@@::::::::::::::@@-:::::::::::::%@<br/>
@%:::PANTRY::::-@@:::SOUTH::::::@@-:::BEDROOM:::%@<br/>
@%:::::::::::::-@@:::HALLWAY::::@@-:::::::::::::%@<br/>
@%:::::::::::::-@@::::::::::::::@@-:::::::::::::%@<br/>
@%:::::::::::::-@@::::::::::::::@@-:::::::::::::%@<br/>
@@%%%%%%%%%%%%%%@@%%%%%%%%%%%%%%@@%%%%%%%%%%%%%%@@<br/>
@@@@@@@@@@@@@@@@@@@@@@@@@@@@@@@@@@@@@@@@@@@@@@@@@@<br/></html>